Sample ID,Fert,Unfert,Total,% Fert,Night
AA,9,233,242,3.719008264,Night 1
AA,11,260,271,4.05904059,Night 1
AA,10,300,310,3.225806452,Night 1
AB,247,9,256,96.484375,Night 1
AB,232,15,247,93.92712551,Night 1
AB,230,15,245,93.87755102,Night 1
AC,330,7,337,97.92284866,Night 1
AC,143,5,148,96.62162162,Night 1
AC,255,15,270,94.44444444,Night 1
AD,276,26,302,91.39072848,Night 1
AD,281,10,291,96.56357388,Night 1
AD,131,20,151,86.75496689,Night 1
AE,17,170,187,9.090909091,Night 1
AE,7,125,132,5.303030303,Night 1
AE,11,141,152,7.236842105,Night 1
AF,70,13,83,84.3373494,Night 1
AF,98,20,118,83.05084746,Night 1
AF,136,22,158,86.07594937,Night 1
AG,125,3,128,97.65625,Night 1
AG,123,6,129,95.34883721,Night 1
AG,138,11,149,92.61744966,Night 1
AH,112,9,121,92.56198347,Night 1
AH,180,16,196,91.83673469,Night 1
AH,140,4,144,97.22222222,Night 1
AI,111,19,130,85.38461538,Night 1
AI,83,19,102,81.37254902,Night 1
AI,68,15,83,81.92771084,Night 1
AJ,119,17,136,87.5,Night 1
AJ,137,9,146,93.83561644,Night 1
AJ,66,6,72,91.66666667,Night 1
BA,243,11,254,95.66929134,Night 1
BA,259,16,275,94.18181818,Night 1
BA,253,7,260,97.30769231,Night 1
BB,1,210,211,0.473933649,Night 1
BB,6,240,246,2.43902439,Night 1
BB,5,275,280,1.785714286,Night 1
BC,274,17,291,94.1580756,Night 1
BC,216,10,226,95.57522124,Night 1
BC,271,7,278,97.48201439,Night 1
BD,175,10,185,94.59459459,Night 1
BD,217,12,229,94.75982533,Night 1
BD,86,10,96,89.58333333,Night 1
BE,14,141,155,9.032258065,Night 1
BE,10,148,158,6.329113924,Night 1
BE,11,152,163,6.748466258,Night 1
BF,138,28,166,83.13253012,Night 1
BF,124,25,149,83.22147651,Night 1
BF,123,16,139,88.48920863,Night 1
BG,124,10,134,92.53731343,Night 1
BG,156,6,162,96.2962963,Night 1
BG,138,7,145,95.17241379,Night 1
BH,160,17,177,90.39548023,Night 1
BH,161,9,170,94.70588235,Night 1
BH,118,4,122,96.72131148,Night 1
BI,100,19,119,84.03361345,Night 1
BI,44,10,54,81.48148148,Night 1
BI,89,23,112,79.46428571,Night 1
BJ,134,17,151,88.74172185,Night 1
BJ,181,27,208,87.01923077,Night 1
BJ,136,19,155,87.74193548,Night 1
CA,243,14,257,94.55252918,Night 1
CA,299,14,313,95.52715655,Night 1
CA,222,20,242,91.73553719,Night 1
CB,230,44,274,83.94160584,Night 1
CB,145,26,171,84.79532164,Night 1
CB,218,52,270,80.74074074,Night 1
CC,8,336,344,2.325581395,Night 1
CC,3,336,339,0.884955752,Night 1
CC,1,277,278,0.35971223,Night 1
CD,4,218,222,1.801801802,Night 1
CD,4,222,226,1.769911504,Night 1
CD,3,200,203,1.477832512,Night 1
CE,41,41,82,50,Night 1
CE,62,66,128,48.4375,Night 1
CE,106,63,169,62.72189349,Night 1
CF,1,127,128,0.78125,Night 1
CF,4,136,140,2.857142857,Night 1
CF,6,175,181,3.314917127,Night 1
CG,245,14,259,94.59459459,Night 1
CG,200,15,215,93.02325581,Night 1
CG,270,12,282,95.74468085,Night 1
CH,200,22,222,90.09009009,Night 1
CH,236,29,265,89.05660377,Night 1
CH,201,21,222,90.54054054,Night 1
CI,154,53,207,74.39613527,Night 1
CI,132,34,166,79.51807229,Night 1
CI,97,23,120,80.83333333,Night 1
CJ,162,28,190,85.26315789,Night 1
CJ,136,32,168,80.95238095,Night 1
CJ,137,31,168,81.54761905,Night 1
DA,236,18,254,92.91338583,Night 1
DA,250,8,258,96.89922481,Night 1
DA,178,12,190,93.68421053,Night 1
DB,225,42,267,84.26966292,Night 1
DB,217,55,272,79.77941176,Night 1
DB,237,65,302,78.47682119,Night 1
DC,3,357,360,0.833333333,Night 1
DC,0,328,328,0,Night 1
DC,2,333,335,0.597014925,Night 1
DD,4,163,167,2.395209581,Night 1
DD,2,232,234,0.854700855,Night 1
DD,12,157,169,7.100591716,Night 1
DE,55,47,102,53.92156863,Night 1
DE,68,61,129,52.71317829,Night 1
DE,45,49,94,47.87234043,Night 1
DF,12,110,122,9.836065574,Night 1
DF,2,191,193,1.03626943,Night 1
DF,10,148,158,6.329113924,Night 1
DG,174,7,181,96.13259669,Night 1
DG,243,16,259,93.82239382,Night 1
DG,215,9,224,95.98214286,Night 1
DH,202,24,226,89.38053097,Night 1
DH,276,15,291,94.84536082,Night 1
DH,272,20,292,93.15068493,Night 1
DI,133,37,170,78.23529412,Night 1
DI,167,45,212,78.77358491,Night 1
DI,187,37,224,83.48214286,Night 1
DJ,145,20,165,87.87878788,Night 1
DJ,76,17,93,81.72043011,Night 1
DJ,145,19,164,88.41463415,Night 1
EA,215,16,231,93.07359307,Night 1
EA,220,14,234,94.01709402,Night 1
EA,284,20,304,93.42105263,Night 1
EB,7,322,329,2.127659574,Night 1
EB,2,291,293,0.682593857,Night 1
EB,5,350,355,1.408450704,Night 1
EC,219,30,249,87.95180723,Night 1
EC,277,27,304,91.11842105,Night 1
EC,276,20,296,93.24324324,Night 1
ED,217,27,244,88.93442623,Night 1
ED,111,11,122,90.98360656,Night 1
ED,145,21,166,87.34939759,Night 1
EE,8,120,128,6.25,Night 1
EE,8,90,98,8.163265306,Night 1
EE,8,142,150,5.333333333,Night 1
EF,88,15,103,85.4368932,Night 1
EF,140,25,165,84.84848485,Night 1
EF,123,24,147,83.67346939,Night 1
EG,236,19,255,92.54901961,Night 1
EG,192,12,204,94.11764706,Night 1
EG,261,18,279,93.5483871,Night 1
EH,211,20,231,91.34199134,Night 1
EH,205,22,227,90.30837004,Night 1
EH,213,28,241,88.38174274,Night 1
EI,186,41,227,81.93832599,Night 1
EI,129,41,170,75.88235294,Night 1
EI,151,17,168,89.88095238,Night 1
EJ,84,13,97,86.59793814,Night 1
EJ,87,21,108,80.55555556,Night 1
EJ,84,22,106,79.24528302,Night 1
FA,226,29,255,88.62745098,Night 1
FA,271,15,286,94.75524476,Night 1
FA,231,13,244,94.67213115,Night 1
FB,197,92,289,68.16608997,Night 1
FB,139,70,209,66.50717703,Night 1
FB,164,68,232,70.68965517,Night 1
FC,0,282,282,0,Night 1
FC,2,182,184,1.086956522,Night 1
FC,1,340,341,0.293255132,Night 1
FD,0,139,139,0,Night 1
FD,2,167,169,1.183431953,Night 1
FD,3,199,202,1.485148515,Night 1
FE,84,122,206,40.77669903,Night 1
FE,56,53,109,51.37614679,Night 1
FE,81,93,174,46.55172414,Night 1
FF,8,144,152,5.263157895,Night 1
FF,4,168,172,2.325581395,Night 1
FF,8,130,138,5.797101449,Night 1
FG,268,20,288,93.05555556,Night 1
FG,226,14,240,94.16666667,Night 1
FG,191,26,217,88.01843318,Night 1
FH,252,16,268,94.02985075,Night 1
FH,168,34,202,83.16831683,Night 1
FH,194,31,225,86.22222222,Night 1
FI,95,30,125,76,Night 1
FI,159,39,198,80.3030303,Night 1
FI,160,31,191,83.76963351,Night 1
FJ,70,29,99,70.70707071,Night 1
FJ,130,56,186,69.89247312,Night 1
FJ,130,45,175,74.28571429,Night 1
GA,263,13,276,95.28985507,Night 1
GA,273,10,283,96.4664311,Night 1
GA,265,10,275,96.36363636,Night 1
GB,134,5,139,96.4028777,Night 1
GB,263,4,267,98.50187266,Night 1
GB,212,7,219,96.80365297,Night 1
GC,277,12,289,95.84775087,Night 1
GC,280,14,294,95.23809524,Night 1
GC,288,20,308,93.50649351,Night 1
GD,223,27,250,89.2,Night 1
GD,273,26,299,91.30434783,Night 1
GD,267,30,297,89.8989899,Night 1
GE,96,40,136,70.58823529,Night 1
GE,94,57,151,62.25165563,Night 1
GE,78,36,114,68.42105263,Night 1
GF,84,9,93,90.32258065,Night 1
GF,178,20,198,89.8989899,Night 1
GF,166,25,191,86.91099476,Night 1
GG,6,243,249,2.409638554,Night 1
GG,7,260,267,2.621722846,Night 1
GG,8,247,255,3.137254902,Night 1
GH,177,14,191,92.67015707,Night 1
GH,216,21,237,91.13924051,Night 1
GH,264,24,288,91.66666667,Night 1
GI,117,24,141,82.9787234,Night 1
GI,140,30,170,82.35294118,Night 1
GI,108,22,130,83.07692308,Night 1
GJ,148,29,177,83.61581921,Night 1
GJ,141,19,160,88.125,Night 1
GJ,162,24,186,87.09677419,Night 1
HA,288,9,297,96.96969697,Night 1
HA,264,12,276,95.65217391,Night 1
HA,287,8,295,97.28813559,Night 1
HB,281,10,291,96.56357388,Night 1
HB,276,11,287,96.16724739,Night 1
HB,261,11,272,95.95588235,Night 1
HC,287,14,301,95.34883721,Night 1
HC,303,15,318,95.28301887,Night 1
HC,325,12,337,96.43916914,Night 1
HD,294,26,320,91.875,Night 1
HD,291,27,318,91.50943396,Night 1
HD,303,18,321,94.39252336,Night 1
HE,127,51,178,71.34831461,Night 1
HE,123,55,178,69.1011236,Night 1
HE,116,62,178,65.16853933,Night 1
HF,194,23,217,89.40092166,Night 1
HF,222,21,243,91.35802469,Night 1
HF,193,17,210,91.9047619,Night 1
HG,297,14,311,95.49839228,Night 1
HG,302,11,313,96.485623,Night 1
HG,294,13,307,95.76547231,Night 1
HH,16,235,251,6.374501992,Night 1
HH,15,246,261,5.747126437,Night 1
HH,18,234,252,7.142857143,Night 1
HI,160,23,183,87.43169399,Night 1
HI,134,30,164,81.70731707,Night 1
HI,164,33,197,83.24873096,Night 1
HJ,25,133,158,15.82278481,Night 1
HJ,30,149,179,16.75977654,Night 1
HJ,21,128,149,14.09395973,Night 1
IA,255,8,263,96.9581749,Night 1
IA,238,3,241,98.75518672,Night 1
IA,250,6,256,97.65625,Night 1
IB,253,33,286,88.46153846,Night 1
IB,217,15,232,93.53448276,Night 1
IB,262,23,285,91.92982456,Night 1
IC,283,14,297,95.28619529,Night 1
IC,292,16,308,94.80519481,Night 1
IC,295,13,308,95.77922078,Night 1
ID,137,11,148,92.56756757,Night 1
ID,142,17,159,89.3081761,Night 1
ID,170,23,193,88.08290155,Night 1
IE,108,58,166,65.06024096,Night 1
IE,117,81,198,59.09090909,Night 1
IE,97,77,174,55.74712644,Night 1
IF,98,11,109,89.90825688,Night 1
IF,164,25,189,86.77248677,Night 1
IF,158,17,175,90.28571429,Night 1
IG,264,15,279,94.62365591,Night 1
IG,368,25,393,93.63867684,Night 1
IG,383,34,417,91.84652278,Night 1
IH,401,21,422,95.02369668,Night 1
IH,432,19,451,95.78713969,Night 1
IH,437,24,461,94.79392625,Night 1
II,14,309,323,4.334365325,Night 1
II,4,315,319,1.253918495,Night 1
II,7,212,219,3.196347032,Night 1
IJ,230,39,269,85.50185874,Night 1
IJ,209,24,233,89.69957082,Night 1
IJ,94,15,109,86.23853211,Night 1
JA,249,20,269,92.56505576,Night 1
JA,256,12,268,95.52238806,Night 1
JA,259,21,280,92.5,Night 1
JB,278,16,294,94.55782313,Night 1
JB,281,29,310,90.64516129,Night 1
JB,292,23,315,92.6984127,Night 1
JC,292,17,309,94.49838188,Night 1
JC,287,20,307,93.48534202,Night 1
JC,264,26,290,91.03448276,Night 1
JD,202,21,223,90.58295964,Night 1
JD,237,21,258,91.86046512,Night 1
JD,215,27,242,88.84297521,Night 1
JE,156,131,287,54.3554007,Night 1
JE,249,150,399,62.40601504,Night 1
JE,194,139,333,58.25825826,Night 1
JF,199,33,232,85.77586207,Night 1
JF,181,33,214,84.57943925,Night 1
JF,155,39,194,79.89690722,Night 1
JG,451,14,465,96.98924731,Night 1
JG,358,23,381,93.96325459,Night 1
JG,405,22,427,94.84777518,Night 1
JH,9,520,529,1.701323251,Night 1
JH,9,435,444,2.027027027,Night 1
JH,8,368,376,2.127659574,Night 1
JI,171,52,223,76.68161435,Night 1
JI,169,45,214,78.97196262,Night 1
JI,217,69,286,75.87412587,Night 1
JJ,17,229,246,6.910569106,Night 1
JJ,14,251,265,5.283018868,Night 1
JJ,24,282,306,7.843137255,Night 1
BATCH,431,16,447,96.42058166,Night 1
BATCH,488,27,515,94.75728155,Night 1
BATCH,490,16,506,96.83794466,Night 1
